123456
### ############# ###
#=  ......*......  =#
# # ############# # #
   ...............   
#.#.### ##### ###.#.#
#.#.#.....#.....#.#.#
#.#.#.###.#.###.#.#.#
#.#. .#.......#. .#.#
#.#.#.#.## ##.#.#.#.#
#.#.#...#   #...#.#.#
#*#.###.  \  .###.#*#
#.#.#...#   #...#.#.#
#.#.#.#.## ##.#.#.#.#
#.#. .#.......#. .#.#
#.#.#.###.#.###.#.#.#
#.#.#.....#.....#.#.#
#.#.### ##### ###.#.#
   ...............   
# # ############# # #
#=  ......*......  =#
### ############# ###